{1,0,0},{1,0,0},{1,0,0},{0,0,0},{1,0,0},{C,0,0},{1,0,0},{1,0,0},{1,0,0},{1,0,0}
{1,0,0},{1,0,0},{1,0,0},{0,0,0},{0,0,0},{0,0,0},{0,0,0},{0,0,0},{0,0,0},{0,0,0}
{0,0,0},{0,0,0},{0,0,0},{0,0,0},{2,1,0},{0,0,0},{1,0,0},{0,0,0},{0,0,0},{0,0,0}
{1,0,0},{0,0,0},{0,0,0},{1,0,0},{1,0,0},{0,0,0},{1,0,0},{0,0,0},{A,0,0},{0,0,0}
{1,0,0},{0,0,0},{0,0,0},{0,0,0},{1,0,0},{0,0,0},{0,0,0},{0,0,0},{1,0,0},{0,0,0}
{1,0,0},{0,0,0},{1,0,0},{0,0,0},{0,0,0},{0,0,0},{0,0,0},{0,0,0},{1,0,0},{0,0,0}
{1,0,0},{0,0,0},{1,0,0},{0,0,0},{0,0,0},{0,0,0},{0,0,0},{0,0,0},{1,0,0},{0,0,0}
{1,0,0},{0,0,0},{0,0,0},{0,0,0},{0,0,0},{1,0,0},{0,0,0},{1,0,0},{1,0,0},{0,0,0}
{0,0,0},{0,0,0},{0,0,0},{1,0,0},{0,0,0},{0,0,0},{0,0,0},{1,0,0},{1,0,0},{0,0,0}
{1,0,0},{1,0,0},{0,0,0},{0,0,0},{0,0,0},{0,0,0},{0,0,0},{0,0,0},{1,0,0},{1,0,0}